7,7,7,7,7,7,7,7,7,7,6,6,6,6,6,6,6,6,6,6,6,6,6,6,7,7,7,7,7,7,7,7,7,7,7,7,7
0,0,0,0,0,0,0,0,0,0,6,6,6,6,6,6,6,6,6,6,6,6,6,6,0,0,0,0,0,0,0,0,0,0,0,0,0
0,0,1,1,0,0,1,1,0,0,2,3,4,4,3,2,0,0,2,3,4,4,3,2,0,0,1,1,0,0,1,1,0,0,5,0,0
0,0,1,1,0,0,1,1,0,0,2,3,4,4,3,2,0,0,2,3,4,4,3,2,0,0,1,1,0,0,1,1,0,0,5,0,0
0,0,1,1,0,0,1,1,0,0,2,3,4,4,3,2,0,0,2,3,4,4,3,2,0,0,1,1,0,0,1,1,0,0,5,0,0
0,0,1,1,0,0,1,1,0,0,2,3,4,4,3,2,0,0,2,3,4,4,3,2,0,0,1,1,0,0,1,1,0,0,5,0,0
0,0,1,1,0,0,1,1,0,0,2,3,4,4,3,2,0,0,2,3,4,4,3,2,0,0,1,1,0,0,1,1,0,0,5,0,0
0,0,1,1,0,0,1,1,0,0,2,3,4,4,3,2,0,0,2,3,4,4,3,2,0,0,1,1,0,0,1,1,0,0,5,0,0
0,0,1,1,0,0,1,1,0,0,2,3,4,4,3,2,0,0,2,3,4,4,3,2,0,0,1,1,0,0,1,1,0,0,5,0,0
0,0,1,1,0,0,1,1,0,0,2,3,4,4,3,2,0,0,2,3,4,4,3,2,0,0,1,1,0,0,1,1,0,0,5,0,0
0,0,0,0,0,0,0,0,0,0,6,6,6,6,6,6,6,6,6,6,6,6,6,6,0,0,0,0,0,0,0,0,0,0,0,0,0
7,7,7,7,7,7,7,7,7,7,6,6,6,6,6,6,6,6,6,6,6,6,6,6,7,7,7,7,7,7,7,7,7,7,7,7,7
